苍白[蒼白]	cang1bai2	adjective 1 pale; pallid; wan 2 lifeless; flat; weak
细瘦[細瘦]	xi4shou4	adjective thin; scrawny
裂缝[裂縫]	lie4feng4	noun 1 rift; crevice; crack; fissure 2 figurative misunderstanding; estrangement of affections  verb (-//-) crack; split
仿佛[仿佛]	fang3fu2	adverb seemingly; as if  verb be more or less the same; be alike (彿彿 fú)
黏性[黏性]	nian2xing4	noun stickiness; adhesiveness; viscidity; viscosity
昆虫[昆蟲]	kun1chong2	noun insect
嗅[嗅]	xiu4	verb smell; scent; sniff
折向后方[折嚮後方]	zhe2 xiang4 hou4fang1	to bend back and forth
瞥见[瞥見]	pie1jian4	verb get a glimpse of; catch sight of
片刻[片刻]	pian4ke4	noun a short while; an instant; a moment
几步外的阴影[幾步外的陰影]	ji3 bu4 wai4 de5 yin1ying3	the shadow a few steps away
敏锐[敏銳]	min3rui4	adjective sharp; acute; keen
甩掉[甩掉]	shuai3//diao4	verb throw off; cast off; shake off; get rid of
兜帽[兜帽]	dou1mao4	hood
砾石[礫石]	li4shi2	noun gravel
烦躁[煩躁]	fan2zao4	adjective fidgety; agitated; irritable
咒骂[咒罵]	zhou4ma4	noun curse; swear; abuse; revile
它弄痛我们的眼睛[它弄痛我們的眼睛]	ta1 nong4 tong4 wo3men5 de5 yan3jing5	it hurts our eyes
尖锐[尖銳]	jian1rui4	adjective 1 sharp-pointed 2 penetrating; incisive; sharp; keen 3 shrill; piercing 4 intense; acute; sharp
肮脏[骯髒]	ang1zang5	adjective 1 dirty; filthy 2 vile; mean; foul; dirty
克制[克制]	ke4zhi4	verb restrain; refrain
拳头[拳頭]	quan2tou5	noun fist  adjective (of products) of good quality and competitiveness; knockout
抽搐[抽搐]	chou1chu4	verb 1 twitch; jerk 2 medicine tic; spasm
厌恶[厭惡]	yan4wu4	verb detest; abhor; abominate; be disgusted with (opp. 喜爱)
自言自语[自言自語]	zi4yan2-zi4yu3	idiom talk to oneself; think aloud; soliloquize
凹[凹]	ao1	verb concave; dent  adjective sunken; dented (opp. 凸)
尖叫[尖叫]	jian1jiao4	verb scream; shriek; yell
冲出[衝出]	chong1chu1	to rush out
收紧[收緊]	shou1//jin3	verb tighten up
剑鞘[劍鞘]	jian4qiao4	scabbard; sheath
伸开[伸開]	shen1//kai1	verb stretch out
割断[割斷]	ge1//duan4	verb sever; cut off
带子[帶子]	dai4zi5	noun 1 belt; girdle; ribbon; band; tape 2 video film; video tape
害死[害死]	hai4si3	1 to kill 2 to cause death 3 to do sb to death
啜泣[啜泣]	chuo4qi4	verb sob
哽[哽]	geng3	verb 1 choke 2 choke (with emotion); feel a lump in one's throat
卑鄙[卑鄙]	bei1bi3	adjective base; mean; contemptible; despicable
勒死[勒死]	lei1//si3	verb strangle
恐惧到了骨子里[恐懼到了骨子裡]	kong3ju4 dao4liao3 gu3zi5li3	Terrified to the bone
刺眼的繁星[刺眼的繁星]	ci4yan3 de5 fan2xing1	the dazzling stars
沼泽[沼澤]	zhao3ze2	noun marsh; swamp; bog
头颈[頭頸]	tou2jing3	noun dialect neck
跟得上[跟得上]	gen1 de5 shang4	to be able to keep up with
念头[念頭]	nian4tou5	noun thought; idea; intention
沟壑[溝壑]	gou1he4	noun gully; ravine
躲[躲]	duo3	verb 1 hide (oneself) 2 avoid; dodge
噎[噎]	ye1	verb 1 choke 2 breathe against the wind with difficulty; be choked by wind 3 dialect render sb. speechless by saying sth. blunt or rude; choke off
嚼[嚼]	jue2	VARIANT OF 23988224嚼jiao2嚼 jiáo verb masticate; chew; munch [limited to use in 咀嚼 jǔjué, 过屠门而大嚼 guò túmén ér dàjué]
笼罩[籠罩]	long3zhao4	verb envelop; shroud
漆黑[漆黑]	qi1hei1	adjective pitch-dark; pitch-black
泥泞[泥濘]	ni2ning4	noun mire; mud  adjective muddy; miry
隐藏[隱藏]	yin3cang2	verb hide; conceal; remain under cover
布巾[布巾]	bu4jin1	a cloth
包围[包圍]	bao1wei2	verb surround; encircle
僵直[僵直]	jiang1zhi2	adjective rigid; stiff
垂[垂]	chui2	verb 1 hang down; droop; let fall 2 literary bequeath to posterity; hand down 3 literary courteous (of one's elders or superiors) condescend  adverb literary near; close to
黏液[黏液]	nian2ye4	noun physiology mucus
烂泥[爛泥]	lan4ni2	noun mud; slush; mire
高傲[高傲]	gao1ao4	adjective 1 supercilious; arrogant; haughty 2 proud; self-respecting; high-minded
吞没[吞沒]	tun1mo4	verb 1 embezzle; misappropriate 2 swallow up; engulf
浑身[渾身]	hun2shen1	noun whole body; from head to foot; all over
抖[抖]	dou3	verb 1 tremble; shiver; quiver 2 shake; jerk 3 rouse; stir up 4 colloquial usually sarcastic [usu. with 起来] get on in the world; gain fame (or fortune) 5 [usu. with 出来] disclose the inside story; expose
试图[試圖]	shi4tu2	verb attempt to (do sth.); try to (do sth.)
丛[叢]	cong2	noun 1 clump; thicket; grove 2 crowd; collection 3 (Cóng) a surname  verb crowd together
芦苇[蘆葦]	lu2wei3	noun reed
纳闷[納悶]	na4men4	1 puzzled 2 bewildered
聆听[聆聽]	ling2ting1	verb literary listen (respectfully)
哆嗦[哆嗦]	duo1suo5	verb tremble; shiver
隐约[隱約]	yin3yue1	adjective indistinct; faint
盘旋[盤旋]	pan2xuan2	verb 1 spiral; circle; wheel 2 linger; stay; hang on; think over
雾气[霧氣]	wu4qi4	noun fog; mist; vapour
僵[僵]	jiang1	adjective stiff; numb  verb dialect stop smiling; look serious  adjective strained; deadlocked
颤抖[顫抖]	chan4dou3	verb shake; tremble; quiver; shiver
黯淡[黯淡]	an4dan4	adjective dim; faint; dismal; gloomy
熄灭[熄滅]	xi1mie4	verb (of a fire, light, etc.) go out; die out
疾风[疾風]	ji2feng1	noun 1 strong wind; gale 2 meteorology moderate gale
畏缩[畏縮]	wei4suo1	verb recoil; shrink; flinch
庞大[龐大]	pang2da4	adjective huge; enormous; colossal; gigantic
尖啸[尖嘯]	jian1xiao4	verb shriek; scream
荒地[荒地]	huang1di4	noun wasteland; uncultivated (or undeveloped) land
威胁[威脅]	wei1xie2	verb threaten; menace; imperil
揉[揉]	rou2	verb 1 rub 2 knead; roll 3 literary bend; twist
噩梦[噩夢]	e4meng4	noun frightening (or horrible) dream; nightmare
扁平[扁平]	bian3ping2	adjective flat
山岭[山嶺]	shan1ling3	noun chain of mountains; mountain ridge
释放[釋放]	shi4fang4	verb 1 release; set free 2 physics release
致命[致命]	zhi4ming4	verb cause death; fatal; mortal; deadly
圈[圈]	quan1	noun 1 circle; ring 2 domain; group; circle(s)  verb 1 enclose; encircle 2 mark with a circle 3 colloquial raise or make money
怒火[怒火]	nu4huo3	noun flames of fury; fury
荒凉[荒涼]	huang1liang2	adjective bleak and desolate; wild
昏暗[昏暗]	hun1an4	adjective dim; dusky
重担[重擔]	zhong4dan4	noun heavy burden; difficult task
链子[鏈子]	lian4zi5	noun 1 chain 2 colloquial roller chain (of a bicycle); chain
颈[頸]	jing3	noun neck
佝偻[佝僂]	gou1lou2	verb bend one's back; stoop
敌对[敵對]	di2dui4	adjective hostile; antagonistic
面纱[面紗]	mian4sha1	noun veil
即使[即使]	ji2shi3	conjunction even; even if; even though; even granted that; notwithstanding
悲惨[悲慘]	bei1can3	adjective miserable; tragic
一举一动[一舉一動]	yi1ju3-yi1dong4	idiom every act and every move; every action
白昼[白晝]	bai2zhou4	noun daytime; day
不祥[不祥]	bu4xiang2	adjective ominous; inauspicious
尽管[儘管]	jin3guan3	adverb 1 feel free to; not hesitate to 2 dialect always; all the time  conjunction though; even though; in spite of; despite
模糊[模糊]	mo2hu5	verb blur; obscure; confuse; mix up  adjective 1 blurred; indistinct; dim; vague 2 mathematics linguistics fuzzy
阴沉[陰沉]	yin1chen2	adjective cloudy; overcast; gloomy; sombre
尽头[盡頭]	jin4tou2	noun end
泥淖[泥淖]	ni2nao4	noun mire; bog; morass
干裂[乾裂]	gan1lie4	verb 1 dry and cracked; chapped 2 forestry seasoning crack
以免[以免]	yi3mian3	conjunction in order to avoid; so as not to; lest
挣扎[掙扎]	zheng1zha2	verb struggle; attempt
呛[嗆]	qiang1	verb choke
雄伟[雄偉]	xiong2wei3	adjective 1 grand; imposing 2 tall and sturdy
甩[甩]	shuai3	verb 1 move backward and forward; swing 2 throw; fling; toss 3 leave sb. behind; throw off
丘陵[丘陵]	qiu1ling2	noun geography hills
不毛[不毛]	bu4mao2	barren
苔藓[苔蘚]	tai2xian3	noun moss
灰烬[灰燼]	hui1jin4	noun ashes
粉末[粉末]	fen3mo4	noun powder
可憎[可憎]	ke3zeng1	adjective detestable; abominable
坟场[墳場]	fen2chang3	noun graveyard; cemetery
暴露[暴露]	bao4lu4	verb expose; reveal; lay bare
散发[散發]	san4fa1	verb 1 send out; send forth; diffuse; emit 2 distribute; issue; give out
喷[噴]	pen1	verb 1 spurt; spout; gush 2 spray; sprinkle
唾沫[唾沫]	tuo4mo5	noun general name for VARIANT OF 31944192唾液tuo4ye4唾液 saliva; spittle
几近[幾近]	ji1jin4	adverb literary close; nearly; on the verge of
极为[極為]	ji2wei2	adverb literary most; extremely; exceedingly
污物[污物]	wu1wu4	noun 1 sewage; rubbish; filth 2 faeces; excrement
水壶[水壺]	shui3hu2	noun 1 kettle 2 canteen 3 watering can
宁静[寧靜]	ning2jing4	adjective peaceful; tranquil; quiet; calm
瘫软[癱軟]	tan1ruan3	1 limp 2 weak
斜坡[斜坡]	xie2po1	1 slope 2 incline
恶臭[惡臭]	e4chou4	1 stink 2 stench 3 to stink 4 to reek
剑柄[劍柄]	jian4bing3	sword hilt
耸立[聳立]	song3li4	verb tower aloft
狭谷[狹谷]	xia2gu3	noun geography defile; narrow gorge
峭壁[峭壁]	qiao4bi4	noun cliff; precipice; steep
衰退[衰退]	shuai1tui4	verb fail; decline
黑暗魔君[黑暗魔君]	hei1an4 mo2jun1	The Dark Lord
哨兵[哨兵]	shao4bing1	noun sentinel; sentry; guard
领土[領土]	ling3tu3	noun territory
趴[趴]	pa1	verb 1 lie on one's stomach; lie prone; prostrate 2 bend over; lean on
隐藏处[隱藏處]	yin3cang2chu4	1 shelter 2 hiding place
涌[涌]	yong3	verb 1 gush; pour; surge 2 rise; spring; well; emerge  noun huge sea waves
咬噬[咬噬]	yao3shi4	verb literary bite; gnaw
投[投]	tou2	verb 1 throw; fling; hurl 2 put in; drop 3 throw oneself into (a river, well, etc. to commit suicide) 4 project; cast 5 send; deliver 6 go to; join 7 fit in with; agree with; cater to 8 literary before; prior to  verb colloquial rinse
遮蔽[遮蔽]	zhe1bi4	verb 1 hide from view; cover; screen 2 obstruct; block 3 military defilade
乌鸦[烏鴉]	wu1ya1	noun crow
塔楼[塔樓]	ta3lou2	noun 1 tower 2 turret 3 tower block (a residential building) (opp. 板楼)
缭绕[繚繞]	liao2rao4	verb literary 1 curl up; wind around 2 entangle
岗哨[崗哨]	gang3shao4	noun 1 lookout post; sentry post 2 sentry; sentinel
